00000000000000000000000000000000000000000000000000
11111111111111111111111111111111111111111111111111
22222222222222222222222222222222222222222222222222
00000000000000000000000000000000000000000000000000
11111111111111111111111111111111111111111111111111
22222222222222222222222222222222222222222222222222
00000000000000000000000000000000000000000000000000
11111111111111111111111111111111111111111111111111
22222222222222222222222222222222222222222222222222
00000000000000000000000000000000000000000000000000
11111111111111111111111111111111111111111111111111
22222222222222222222222222222222222222222222222222
00000000000000000000000000000000000000000000000000
11111111111111111111111111111111111111111111111111
22222222222222222222222222222222222222222222222222
00000000000000000000000000000000000000000000000000
11111111111111111111111111111111111111111111111111
22222222222222222222222222222222222222222222222222
00000000000000000000000000000000000000000000000000
11111111111111111111111111111111111111111111111111
22222222222222222222222222222222222222222222222222
00000000000000000000000000000000000000000000000000
11111111111111111111111111111111111111111111111111
22222222222222222222222222222222222222222222222222
00000000000000000000000000000000000000000000000000
11111111111111111111111111111111111111111111111111
22222222222222222222222222222222222222222222222222
00000000000000000000000000000000000000000000000000
11111111111111111111111111111111111111111111111111
22222222222222222222222222222222222222222222222222
00000000000000000000000000000000000000000000000000
11111111111111111111111111111111111111111111111111
22222222222222222222222222222222222222222222222222
00000000000000000000000000000000000000000000000000
11111111111111111111111111111111111111111111111111
22222222222222222222222222222222222222222222222222
00000000000000000000000000000000000000000000000000
11111111111111111111111111111111111111111111111111
22222222222222222222222222222222222222222222222222
00000000000000000000000000000000000000000000000000
11111111111111111111111111111111111111111111111111
22222222222222222222222222222222222222222222222222
00000000000000000000000000000000000000000000000000
11111111111111111111111111111111111111111111111111
22222222222222222222222222222222222222222222222222
00000000000000000000000000000000000000000000000000
11111111111111111111111111111111111111111111111111
22222222222222222222222222222222222222222222222222
00000000000000000000000000000000000000000000000000
11111111111111111111111111111111111111111111111111
22222222222222222222222222222222222222222222222222
00000000000000000000000000000000000000000000000000
11111111111111111111111111111111111111111111111111
22222222222222222222222222222222222222222222222222